WWWWWWWWWWWWWWW
W W       W   W
W WWW WWW WWW W
W   W   W W   W
WWW WWW W W WWW
W W W   W W   W
W W W WWW WWW W
W   W W W W   W
W WWW W W W W W
W    TW W W W W
WWWWWWW W W WWW
W   W   W W   W
W WWW W W WWW W
W     W       W
WWWWWWWWWWWWWWW
