WWWWWWWWWWWWWWWWWWWWW
W     WDD W    D D  W
WWWWW W WDWWWWW WWW W
W D W  DW  D  W  DW W
WWW WWWWWWWWW WWW W W
W   D W     WDW   W W
W W WWWDWWW W W WWW W
W W W   WDW   W W   W
W W W WWWDWWWWWWWDW W
W W W      DD   W W W
W W WWWWWWWWWWWDW W W
W W   W  D    W W W W
W WWWWW WWW W W W W W
W   W   W   W WD  W W
W W W WWWDWWW WWWWW W
W W W WDW   W WDW   W
W W W W WWW W W W WWW
W W WTW  DW W   W WDW
W W W WDW WDWWWWW W W
W W   DDW WT        W
WWWWWWWWWWWWWWWWWWWWW